F 190,227,245
C 252,195,195

NO textures/cursedcat.xpm
SO textures/curseddog.xpm
WE textures/actually.xpm
EA textures/catmeme.xpm

1111111111111111
1000000000000001
1001111000000001
1001   100000001
1001   100000001
1001111000000011
1000000000011111
100000000001   1
100000011111   1
1000000000N1   1
1111111111111111
