F 120,7,7
C 255,0,0

NO cub3D/textures/eclipse.xpm
EA cub3D/textures/rage.xpm
WE cub3D/textures/guts.xpm
SO cub3D/textures/wrong.xpm

11111111111111111111111111111111
10000000000000000E00000000000001
10011111111111111111111111111001
10010000000000000000000000001001
10010011111110000011111000101001
10010010000010000010001000101001
10010010000010000010001000101001
10010010000010000010001000101001
10010010000000000000001000101001
10010011111111111111111000101001
10010000000000000000000000001001
10011111111111111111111111111001
10000000000000000000000000000001
10000011111111111111111110000001
10000000000000000000000110000001
10000010000000000000000110000001
10000010000000000000000110000001
10000010000000000000000110000001
10000010000000000000000000000001
10000011111111111111111110000001
10000000000000000000000000000001
10000000000000000000000000000001
10000011111111111111111110000001
10000010000000000000000000000001
10000010000000000000000110000001
10000010000000000000000110000001
10000010000000000000000110000001
10000010000000000000000110000001
10000011111111111111111110000001
10000000000000000000000000000001
10000000000000000000000000000001
10011111111111111111111111111001
10010000000000000000000000000001
10011111111111111111111111111001
10000000000000000000000000000001
11111111111111111111111111111111
