F 120,117,115
C 101,00000016,204

NO textures/TEXT_NO.xpm
SO textures/TEXT_SO.xpm
WE textures/TEXT_WE.xpm
EA textures/TEXT_EA.xpm

1111111111111111
1000000000000001
1001111000000001
1001   100000001
1001   100000001
1001111000000011
1000000000011111
100000000001   1
100000011111   1
1000000000W1   1
1111111111111111
