F 120,117,115
C 101,00000016,204

NO textures/TEXT_NO.xpm
SO textures/TEXT_SO.xpm
WE textures/TEXT_WE.xpm
EA textures/TEXT_EA.xpm

1111111111111111
1000000000000001
1000000000000001
1000011111100001
100001     10001
100001     10001
1111111111 10001
1000000001 10001
1000000001110001
1000N00000000001
1111111111111111
