F 120,117,115
C 101,00000016,204

NO textures/TEXT_NO.xpm
SO textures/TEXT_SO.xpm
WE textures/TEXT_WE.xpm
EA textures/TEXT_EA.xpm

1111111111111111
1000000N00000001
1000000000000001
1000001000111101
1000010000000101
1000100000001001
1001111000010001
1000001000100001
1000001000111101
1000000000000001
1111111111111111
