F    220,100,1

C           220,100,1



NO    . ./ntexture.txt

SO                 ./ntexture.txt

WE ./ntexture.txt

EA             ./ntexture.txt

























              1

1

1           1111111    11

11111111 1111 111101111 1

       111111111101111

1   110000000000001

       100000000000001

       111111111111111

       111

            111

         1
