F	1,2,3
C 1,2,3
    
NO .
SO .
WE .
EA .
1111