F	000,255,253
C   123,2,3
    





NO textures/TEXT_NO.xpm
SO textures/TEXT_SO.xpm
WE textures/TEXT_WE.xpm
EA textures/TEXT_EA.xpm


111111
100N01
100001
100001
111111