F	120,117,115
C   101,00000016,204
    



NO textures/TEXT_NO.xpm
SO textures/TEXT_SO.xpm
WE textures/TEXT_WE.xpm
EA textures/TEXT_EA.xpm


1111111111111111
1000000000000001
1000000000000001
1000000111110001
10000001   10001
10000001   10001
10000001   10001
10000001   10001
10000001   10001
100000N1   10001
11111111   11111