F	1,2,3
C 1,2,3
    





NO .
SO .
WE .
EA .


111111
100N01
100001
100001
111111