F	100,255,150
C   0,2,183
    



NO textures/TEXT_NO.xpm
SO textures/TEXT_SO.xpm
WE textures/TEXT_WE.xpm
EA textures/TEXT_EA.xpm


1111111111111111
1000000000W00001
10000000000000001  
10000001111100011
10000001 	10001
10000001   10001
10000001 1  10001
10000001   10001
10000001   10001
11000001   10001
11111111   11111
