F	100,255,150
C   0,2,183
    





NO textures/HelloKitty.xpm
SO textures/TEXT_SO.xpm
WE textures/TEXT_WE.xpm
EA textures/TEXT_EA.xpm


1111111
100001
100W01
100001
100001
100101
101 11
100101
10001
100101
111111