NO	./ntexture.txt			
SO 				./ntexture.txt
WE ./ntexture.txt
EA 			./ntexture.txt
F 220,100,0
C	 225,30,0 

1
1
1
11111111 1111 1111 1111 1
       111111111111111
	   110000000000001
	   100000000000001
	   111111111111111
	   111
	   	 111
		 1
