F	120,117,115
C   101,00000016,204
    



NO textures/TEXT_NO.xpm
SO textures/TEXT_SO.xpm
WE textures/TEXT_WE.xpm
EA textures/TEXT_EA.xpm


11111111
1E000001
11111111
11111111   11111
