F	1,2,3
C 1,2,3
    






NO .
SO .
WE .
EA .

   
     
	  

                       a
11111	111
	 111	10