F 190,227,245
C 252,195,195

NO textures/dog.xpm
SO textures/curseddog.xpm
WE textures/actually.xpm
EA textures/catmeme.xpm


111 1111111111111
1111000000000001
111111100000000E1
101   1000000001
1101   100000001
1001111000000011
1000000000011111
100000000001   1
1110000011111   1
100000000001   1
1111111111111111
