F 120,117,115
C 101,00000016,204

NO textures/TEXT_NO.xpm
SO textures/TEXT_SO.xpm
WE textures/TEXT_WE.xpm
EA textures/TEXT_EA.xpm

1111111111111111
1000000000000001
1000000000000001
1000111111000001
1000100010000001
1000100010000001
1000100010000001
1000111110000001
1000000000000001
10000000N0000001
1111111111111111
