C 0,0,0
F 129,0,0

NO textures/uzu2.xpm
SO textures/uzu.xpm
WE textures/tomie.xpm
EA textures/tomie2.xpm

111111 1111 111111
11111110000111111
11111 110W1111 11  111
	1110000000111111
111110000000000000111
	1111100000000011111
	1100000000000010101
	1110001111100000001
	1111001111001110011
	1100000000000000001
	 111111100000000011
	 	111100011110001
			1111111111