C 1,1,1
F 129

NO textures/uzu2.xpm
SO textures/uzu.xpm
WE textures/tomie.xpm
EA textures/tomie2.xpm

111111 1111 111111
11111 110W1111 11  111
	   111 