C 0,0,0
F 92,92,92

NO textures/uzu2.xpm
SO textures/uzu.xpm
WE textures/tomie.xpm
EA textures/tomie2.xpm

1111111111111111
1000000000000001
1000000N00000001
1000001000111101
1000010000000101
1000100000001001
1001111000010001
1000001000100001
1000001000111101
1000000000000001
1111111111111111
